 ##### ### ### ### ################### #  
#.....#...#...#...#...................#.# 
#.#.#.#.#.#.#.#.#.#.#########.#######.#.# 
#.#.#...#...#.#.#.....#.....#.#.....#.#.# 
 ##.#########.#.#####.#####.#.#.###.#.#.# 
#...#.....#...#.#...#.......#.#.#.#...#.# 
#.#####.#.#.#####.#.#####.###.#.#.#####.# 
#.#.....#.#.....#.#.....#.#...#...#.#...# 
#.#.###.#######.#.#####.#.#.#####.#.#.#.# 
#.#.#...#.....#...#.....#.#.....#.#...#.# 
#.#.#####.#.#.#####.#########.#.#.#####.# 
#.#...#...#.#.#...#.#.......#.#.#.....#.# 
#.###.#.###.###.#.#.#.#####.###.#####.#.# 
#.#...#.#.#.#...#...#...#.#.....#.#...#.# 
#.#.#.#.#.#.#.#########.#.#######.#.###.# 
#.#.#.#...#.#.#.......#.#...#...#...#...# 
#.#.#####.#.#.###.###.#.###.#.#.#.#####.# 
#.#.......#.#...#.#...#...#...#.........# 
#.#.#######.###.#.#.#####.#.###########.# 
#.#.#...#.....#...#.......#.....#.....#.# 
#.#.###.#.#.###.#################.###.#.# 
#.#.#...#.#.#...#...#S..#.......#.#.#.#.# 
#.#.#.###.#.#.###.#.###.#.#####.#.#.#.##  
#.#...#...#.#.#.#.#...#.#...#.#...#.#...# 
#.###.#.## ##.#.#.###.#.###.#.#####.###.# 
#...#.#...#...#.#...#...#...#.#.........# 
 ##.#####.#.###.###.#####.###.#.########  
#...#...#.#...#...#.......#.....#.....#.# 
#.###.#.#.###.#.###########.#####.###.#.# 
#.#...#.#.......#.....#.....#.....#...#.# 
#.#.###.#.#####.#.###.#.#######.###.###.# 
#.#.#.#.#.#...#.#.#.#...#.......#.#...#.# 
#.#.#.#.#.#.#.###.#.#######.#####.###.#.# 
#.#...#.#.#.#...#.#.........#.......#.#.# 
#.###.#.###.###.#.#.#####.###.#####.#.#.# 
#...#.#...#...#...#...#...#.....#O..#...# 
#.#.#.###.###.#########.#######.#######.# 
#.#.#...#...#...#.....#.....#...#.....#.# 
#.#.###.###.###.#.###.#####.#.###.###.#.# 
#.#.......#.......#.........#.......#...# 
 # ####### ####### ######### ####### ###  
                                          
